#####################
#S                # #
# ############### # #
# #               # #
# #               # #
# #               # #
# #               # #
# #               # #
# #               # #
# #               # #
# #               # #
# #               # #
# #               # #
# #               # #
# #               # #
# #               # #
# #               # #
# #               # #
# ################# #
#                   #
#####################